[
    {
      "type": "palette",
      "id": "natural_cave",
      "terrain": { "#": "t_rock", " ": [ "t_rock_floor" ], "m": "t_dirtfloor", "X": "t_rock_floor" },
      "furniture": { "X": "f_bathtub", "Y": "f_shower" }
    },
    {
      "type": "mapgen",
      "method": "json",
      "om_terrain": [ "natural_cave_remarkable_cross" ],
      "weight": 1,
      "object": {
        "fill_ter": "t_rock",
        "rows": [
          "############X###########",
          "########################",
          "########################",
          "########################",
          "########################",
          "########################",
          "########################",
          "########################",
          "########################",
          "########################",
          "########################",
          "########################",
          "X######################X",
          "########################",
          "########################",
          "########################",
          "########################",
          "########################",
          "########################",
          "########################",
          "########################",
          "########################",
          "########################",
          "############X###########"
        ],
        "palettes": [ "natural_cave" ]
      }
    },
    {
      "type": "mapgen",
      "method": "json",
      "om_terrain": [ "natural_cave_remarkable_tee" ],
      "weight": 1,
      "object": {
        "fill_ter": "t_rock",
        "rows": [
          "############X###########",
          "########################",
          "########################",
          "########################",
          "########################",
          "########################",
          "########################",
          "########################",
          "########################",
          "########################",
          "########################",
          "########################",
          "#######################X",
          "########################",
          "########################",
          "########################",
          "########################",
          "########################",
          "########################",
          "########################",
          "########################",
          "########################",
          "########################",
          "############X###########"
        ],
        "palettes": [ "natural_cave" ]
      }
    },
    {
      "type": "mapgen",
      "method": "json",
      "om_terrain": [ "natural_cave_remarkable_line" ],
      "weight": 1,
      "object": {
        "fill_ter": "t_rock",
        "rows": [
          "############X###########",
          "########################",
          "########################",
          "########################",
          "########################",
          "########################",
          "########################",
          "########################",
          "########################",
          "########################",
          "########################",
          "########################",
          "########################",
          "########################",
          "########################",
          "########################",
          "########################",
          "########################",
          "########################",
          "########################",
          "########################",
          "########################",
          "########################",
          "############X###########"
        ],
        "palettes": [ "natural_cave" ]
      }
    },
    {
      "type": "mapgen",
      "method": "json",
      "om_terrain": [ "natural_cave_remarkable_elbow" ],
      "weight": 1,
      "object": {
        "fill_ter": "t_rock",
        "rows": [
          "############X###########",
          "########################",
          "########################",
          "########################",
          "########################",
          "########################",
          "########################",
          "########################",
          "########################",
          "########################",
          "########################",
          "########################",
          "#######################X",
          "########################",
          "########################",
          "########################",
          "########################",
          "########################",
          "########################",
          "########################",
          "########################",
          "########################",
          "########################",
          "########################"
        ],
        "palettes": [ "natural_cave" ]
      }
    },
    {
      "type": "mapgen",
      "method": "json",
      "om_terrain": [ "natural_cave_remarkable_end" ],
      "weight": 1,
      "object": {
        "fill_ter": "t_rock",
        "rows": [
          "############X###########",
          "########################",
          "########################",
          "########################",
          "########################",
          "########################",
          "########################",
          "########################",
          "########################",
          "########################",
          "########################",
          "########################",
          "########################",
          "########################",
          "########################",
          "########################",
          "########################",
          "########################",
          "########################",
          "########################",
          "########################",
          "########################",
          "########################",
          "########################"
        ],
        "palettes": [ "natural_cave" ]
      }
    },
    {
        "//": "mossy refuge",
        "type": "mapgen",
        "method": "json",
        "om_terrain": [ "natural_cave_remarkable_elbow" ],
        "weight": 1000,
        "object": {
          "fill_ter": "t_rock_floor",
          "rows": [
            "############ ###########",
            "############ ###########",
            "#########     ##########",
            "########   ##   ########",
            "#########   ### ########",
            "########### ############",
            "########## mmmmmmmm#####",
            "###########mmmmmmmm#####",
            "########## mmmmmmmm#####",
            "###########mmmmmmmm#####",
            "############mmmm########",
            "#############mmm########",
            "##############mmmmmmmmm ",
            "########################",
            "########################",
            "########################",
            "########################",
            "########################",
            "########################",
            "########################",
            "########################",
            "########################",
            "########################",
            "########################"
          ],
          "palettes": [ "natural_cave" ]
        }
      }
  ]
  